# File
-> Ctrl+N "New"
-> Ctrl+Shift+N "New Window"
-> Ctrl+O "Open"
-> Ctrl+P "Open Quickly"
-> Ctrl+Shift+T "Reopen Closed File"
-> Ctrl+S "Save"
-> Ctrl+Shift+S "Save As"
-> Ctrl+, "Preference"
-> Ctrl+W "Close"

Edit
Function 			Hotkey
New Paragraph 			Enter
New Line 			Shift+Enter
Cut 				Ctrl+X
Copy 				Ctrl+C
Paste 				Ctrl+V
Copy As Markdown 		Ctrl+Shift+C
Paste As Plain Text 		Ctrl+Shift+V
Select All 			Ctrl+A
Select Line/Sentence
Select Row (in table) 		Ctrl+L
Delete Row (in table) 		Ctrl+Shift+Backspace
Select Style Scope
Select Cell (in table) 		Ctrl+E
Select Word 			Ctrl+D
Delete Word 			Ctrl+Shift+D
Jump to Top 			Ctrl+Home
Jump to Selection 		Ctrl+J
Jump to Buttom 			Ctrl+End
Find 				Ctrl+F
Find Next 			F3 or Enter
Find Previous 			Shift+F3 or Shift+Enter
Replace 			Ctrl+H

Paragraph
Function 			Hotkey
Heading 1 to 6 			Ctrl+1-6
Paragraph 			Ctrl+0
Increase Heading Level 		Ctrl+=
Decrease Heading Level 		Ctrl+-
Table 				Ctrl+T
Code Fences 			Ctrl+Shift+K
Math Block 			Ctrl+Shift+M
Quote 				Ctrl+Shift+Q
Ordered List 			Ctrl+Shift+[
Unordered List 			Ctrl+Shift+]
Indent 				Ctrl+[ or Tab
Outdent 			Ctrl+] or Shift+Tab

Format
Function 			Hotkey
Strong 				Ctrl+B
Emphasis 			Ctrl+I
Underline 			Ctrl+U
Code 				Ctrl+Shift+`
Strike 				Alt+Shift+5
Hyperlink			Ctrl+K
Image 				Ctrl+Shift+I
Clear Format 			Ctrl+\

View
Function 			Hotkey
Toggle Sidebar 			Ctrl+Shift+L
Outline 			Ctrl+Shift+1
Articles 			Ctrl+Shift+2
File Tree 			Ctrl+Shift+3
Source Code Mode 		Ctrl+/
Focus Mode 			F8
Typewriter Mode 		F9
Toggler Fullscreen 		F11
Actual Size 			Ctrl+Shift+0
Zoom In 			Ctrl+Shift+=
Zoom Out 			Ctrl+Shift+-
Switch Between Opened Documents	Ctrl+Tab
Toggle DevTools 		Ctrl+Shift+I
